11 9
RRRRRRRRRRR
RGBYBBYYBBR
RBRBRMRYRBR
RYBBBYYYBBR
RBRBRYRMRBR
RBBYBYYBBBR
RBRYRBRYRMR
RBBYBBBYBMR
RRRRRRRRRRR